Base	base
Brick	brick
Brush	brush
Cobblestone	cobblestone
Cracked	crack
Creep	creep
Crop	crop
Dirt	dirt
Fern	fern
Flower	flower
Footprints	footprints
Grass	grass
Ice	ice
Leaf	leaf
Mud	mud
Moss	moss
Road	road
Rock	rock
Root	root
Rubble	rubble
Sand	sand
Shore	shore
Straw	straw
Weed	weed